11111111111111111111111
10000000000000000000001
10000000P00000000000E01
10000000000000000000001
100000000000C0000000001
10000000000000000000001
10000000000000000000001
10000000000000000000001
10000000000011011100001
10000000000000000000001
10000000000000000000001
11111111111111111111111
