11111111111111111111111
10000000000000000010001
10000000000000000000E01
100000000C0000000011111
10000P00000000000000001
11111111111111111111111
