11111111111111111111111
10000000000000010000001
10000000000000000000E01
100111100C0000000011111
10010P10000000000000001
11111111111111111111111
