11111111111111111111111
10000000000010000000001
10000000P00010000000001
10000000000010000000001
1000000000001000000E001
1000000C000000000000001
10000000000010000000001
10000000000010000000001
10000000000011111111111
10000000000000000000001
10000000000000000000001
11111111111111111111111
