11111111111111111111111
10000000000010000000001
10000000P00010000000001
10000000000010000000001
1000000000001000000E001
1000000C000000000000001
10000000001110000000001
10000000000010000000001
10000001100011111111111
10000010000000000000001
10000100000000000000001
11111111111111111111111
