11111111111111111111111
10000000000010000000001
10000000P00010000000001
10000000000010000000001
100000000000C000000E001
10000000000010000000001
10000000000010000000001
10000000000010000000001
10000000000011011111001
10000000000000000000001
10000000000000000000001
11111111111111111111111
