11111111111111111111111
10000000000000000001E01
10000000000000000001111
10000000000000000000001
100C00000000P0000000001
11111111111111111111111
