1111111111111111111111
100000000000000001E001
1000000000000000011111
1000P0000000C000000001
1000000000000000000001
1111111111111111111111
