11111111
1001E001
10011111
1PC00001
10000001
11111111
